1111111111111111111111111
1E000000000C00000C0000001
1010010100001010010010101
1010010101010010010010101
1010010100C01010010010101
1010C10101010010010010101
1P0000000C00C0000000000C1
1111111111111111111111111